%%%%%%%%%%%%%%%
%.       .%   %
%.%.%.%.%.% % %
%   P       % %
%%%%%%%%%%%%% %
%.....        %
%%%%%%%%%%%%%%%
